$$$ exec p1 : [./filler]
Plateau 28 34:
    0123456789012345678901234567890123
000 ................OO...O............
001 .......OO...O..OOOOOOO............
002 o.OOOOOOO.OOOOOOOOOO.O...OO.......
003 oOOOOOOOOOOOOOOOOOOOOOOOOOOOOOOOOO
004 OOOOOOOOOOOOOOOOOOOOOOOOOOOOOOOOOO
005 OOOOOOOOOOOOOOOOOOOOOOOOOOOOOOOOOO
006 OOOOOOOOOOOOOOOOOOOOOOOOOOOOOOOOOO
007 OOOOOOOOOOOOOOOOOOOOOOOOOOOOOOOOOO
008 OOOOOOOOOOOOOOOOOOOOOOOOOOOOOOOOOO
009 OOOOOOOOOOOOOOOOOOOOOOOOOOOOOOOOOO
010 OOOOOOOOOOOOOOOOOOOOOXOXOOOOOOOOOO
011 OOOOOOOOOOOOOOOOOOOOOXXXXXOOOOOOOO
012 OOOOOOOOOOOOOOOOOOOOOXXXXXXXXOOOOO
013 OOOOOOOOOOOOOOOOOXXOXXXXXXXXOOOOOO
014 OOOOOOOOOOOOOOOXXXXXXXXXXXXXOOOOOO
015 OOOOOOOOOOOOOOOXXXXXXXXXXXXXOOOOOO
016 OOOOOOOOOOOOOOOXXXXXXXXXXXXOOOOOOO
017 OOOOOOOOOOOOOOOXXXXXXXXXXXXXOOOOOO
018 OOOOOOOOOOOOOOOXXXXXXXXXXXXXXXOOOO
019 .OOOOOOOOOOOOOOXXXXXXXXXXXXXXXOOOO
020 OOOOOOOOOOOOOOOOOXXXXXXXXXXXXXOOOO
021 .OOOOOOOOOOOOOOOOXXXXXXXXXXXXXXXXO
022 .OOOOOOOOOOOOOOOOOOOXXXXXXXXXXXXOO
023 OOOOOOOOOOOOOOOOOOOOXXXXXXXXXXXXOO
024 .OO.OOOOOOOOOOOOOOOOXXXXXXXXXXXOOO
025 ...OOOOOOOOOOOOOOOOOOOXXXXXXXXXOOO
026 ....OOOOOOOOOOOOOOOOOOXXXXXX.XXOOO
027 ......OOOOOOOOOOOOOOOOXXXXX.XXXOOO
Piece 5 6:
...**.
..***.
...**.
....**
......
