$$$ exec p1 : [./filler]
Plateau 28 34:
    0123456789012345678901234567890123
000 ..................................
001 ..................................
002 .....................XX...........
003 ...................XXXX...........
004 ....................XXxxx.........
005 ....................X.X...........
006 ....................X.............
007 ....................X.............
008 ...............O....X.............
009 ...................XX.............
010 ..................XX..............
011 .................XX...............
012 .................X................
013 ................XX................
014 .................X................
015 .................XXXX.............
016 ...............XXX................
017 ...............XX.................
018 ...............X..................
019 ..................................
020 ..................................
021 ..................................
022 ..................................
023 ..................................
024 ..................................
025 ..................................
026 ..................................
027 ..................................
Piece 3 4:
..*.
..**
..**
